11111111
10000111
10000111
10100111
1P000111
11111111