1111111
1P001E1
1000001
1C00001
1111111