11111111
10000E01
10000001
10100101
1P000C01
11111111