11111111
10000E11
10000011
10100111
1P000C11
11111111