1111111111
10001E1001
1000001001
1C00000001
1111111111